+------+---------+-----+
|      |         |     |
| I    |         |   + |
|      |         |   |  
|      |---+     +-+ +-+
|      +   |           |
|          |    +      |
|      +   +    |      |
|      |        |      |
+------+---+----+------+
